1,1,2,3,4
2,5,6,7,3,8,9,10,11,12,13,14,15,16,17
3,18,14,19,20,21,22,23,24,25,26,27,28,29,30,31,32,33,34,35,36
4,37,38,39,40,41,42,43,44,45,46,47,3,48
5,49,50,51,52,53,54,55,56,57,58,59,60,61,40,62,63,64,65,66,67
6,68,31,69,70,71,58,62,72,15,73,74,75,38,76,77,12,39,78,79,44
7,80,7,81,79,82,13,83,84,85,86,76,8,19,87,74,88,89,90,91,71
8,92,93,6,94,95,96,34,86,4,11,3,17
9,6,7,69,97,98,99,47
10,6,7,69,97,98,99,47
11,5,74,100,101,46,40,102,103,104,86,105,47,38,12,106,3,107,108,48,109
12,69,110,76,11,111,112,13,113,114,16,115,71,116,117,3,4,118,119,38,12
13,70,79,19,120,121,122,123,124,125,126,127,128,129,130,131,115,89,48,132,133
14,134,50,135,136,137,138,139,140,141,142,143,144,145,146,147,148,149,150,151,152
15,105,153,154,155,156,73,75,62,157,133,132,158,91,159,160,42,161,162,163,164
16,165,12,44,47,166,97,167,46,38,168,169,99
17,170,136,171,72,130,172,173,174,99,175,71,176,69,5,162,177,104,178,47,179
18,180,64,181,65,182,183,184,62,185,54,109,186,46,73,131,115,89,117,39,48
19,187,188,189,190,191,192,193,194,195,196,197,146,74,198,199,200,35,201,202,203
20,69,86,204,79,62,40,73,179,17,117,39,15,12,42,168,205,77,75
21,206,207,208,209,210,211,212,213,69,214,215,216,3,217,218,219,80,220,221,222
22,223,224,225,226,227,228,229,104,86,176,230,221,231,232,233,19,234,235,236,82
23,149,237,238,69,239,62,12,65,87,77,75,73
24,240,241,75,242,16,15,12,199,47,243,83,244,117,39,11,3,177
25,245,246,247,248,249,250,251,252,253,254,255,256,257,258,259,260,261,262,263,264
26,42,125,220,75,110,62,3,265,99,47,126,266,45
27,143,267,225,40,87,42,121,31,62,75
28,268,61,111,119,38,12
29,269,7,270,103,62,271,99,112,47,115,116,89,109,39,3,48,4,15,75,73
30
31,123,272,85,175,13,172,273,112,74,16,105,106,3,11,102,17
32,274,275,276,277,69,147,278,279,280,281,282,111,56,283,284,180,285,286,287,288
33,114,79
34,84,86,141,199,131,74,105,106,38,121,118,17,71,47,89,76,3
35,289,290,291,292,293,294,295,75,42,296,131,297,298,299,47,11,39,4,48,3
36,300,301,98,178,302,303,304,305,104,62,306,307,308,309,310,311,13,312,313,162
37,119,314,315
38,316,317,318,319,320,321,76,322,161,323,62,324,325,42,326,77,75,73,327,112
39,328,329,330,234,331,204,40,225,212,332,24,333,334,335,237,336,337,338,339,93
40
41
42,47,3
43,225,199,340,214,91,234,62,341,342,343,38,83,15,71,268,344,57,278,17,117
44,345,346,347,348,49,349,350,351,352,353,354,355,356,357,236,358,154,359,360,361
45,362,363,364,365,366,234,367,368,369,370,148,329,56,371,40,372,373,278,374,375
46,376,117
47,104,86,36,377,125,121,48,4,3,42
48,11,106,3
49,378,379,380,328,381,30,382,162,69,383,384,385,386,240,7,387,388,389,313,390
50,198,391,392,93,393,125,86,34,394,395,396,397,126,17,3
51,92,398,391,393,399,400,55,36,62,126,125,3
52,152,401,402,403,42,327,270,112,16,90,76,73
53,73,404,405,197,406,115,323,394,391,76,125,62,3,48,4
54,102,4
55,407,408,362,409,410,236,411,65,412,113,99,172,108,8,131,47,106,74,327,71
56,413,225,357,414,96,415,416,83,7,417,418,419,122,376,420,296,421,422,423,424
57
58,146,425,426,240,389,72,117,386,427,214
59,428,57,429,342,340,114,430,353,431,432,31,178,433,434,105,71,76,435,396,34
60,436,103,69,437,152,438,292,225,439,440,441,442,93,86,65,186,400,443,444,445
61,446,447,69,236,448,308,449,214,450,451,452,453,454,455
62,89,456,121,108
63,457,118,458,306,459,310,31,460,121,461,462,75,77,103,463,62,86,44,464,102
64,263,70,465,62,273,114,44,46,75,327,71,102,121,466,467,422,468,47,469,112
65,97,470
66,355,352,471,93,103,472,332,368,473,474,436,475,16,357,476,236,268,394,400,401
67,54,283,329,117,38
68,93,96,34,401,342,99,8,16,131,74,47,327,115,105,71,89,76,106,17,4
69,51,414,75,477,478,73,479,39,77
70,480,1,481,153,482,483,484,485,486,487,488,489,78,490,342,117,491,492,493,494
71,62,128,342,153,155,105,79,118,109,495,120,496,165,389,31,399,400,162,69,125
72,497,3,89,116
73,281,205,498,278,138,499,98,199,315,500,501,105,502,113,234,423,16,117,503,3
74,118,243,47,504,339,505,506,3,198,408
75
76,22,442,507,479,225,198,33,508,69,425,146,93,509,404,510,125,405,47,511,89
78,17,380,116,42,48,3,4,89,12,121,327,73,39,177,45
79,70,16,512,99,130,45,158,513,91,17,112,327,4,48,514,105,76,8,106,125
80,168,86,4,42,11,3,48,17,77,117,106,102,515,39,119,38,121
81,48,3,401,516,517,170,518,519,520,521,522,101,523,524,272,525,158,278,85,321
82,526,527,86,133,69,516,401,162,79,115,76,16,114,4,131,12,108,71,47,89
83,528,38,275,529,530,40,111,71,131
84,505,528,90,57,40,531,93,86,30,532,103,533,104,119,48,515,4,3,77,39
85,72,44,534,535,536,401,83,537,125,538,158,162,133,15,273,19,132,539,540,110
86,541,542,543,277,109,544,236,69,86,394,545,546,547,214,5,125,47,177,376,548
87
88
89,221,79,155,365,225,211,549,550,56,329,505,72,61,551,287,552,55,40,38
90,553,382,554,555,458,225,13,556,557,558,559,533,560,561,47,405,394,562,113,93
91
92,233,62,125,563,564,315,158,412,565,83,7,40,162,71,106,4,48,16,228,86
93,566,567,34,161,77,11,42,39,48,4,3,17,38,12,121,117
94,12,119,77,39,11,3,117
95
96,170,86,91,82,568,158,99,12
97
98,62,110,79,91,69,114,45,112,74,199,99,172,16,8,47,105,115,71,116,76
99,389,152,528,170,569
100,177,3,15,75,102,17,62,12,77
101,342,570,3,199,44,89
102,120,571,62,401,3,11,540,86,572,535,162,83,312,536,75,112,327,74,131,106
103,573,103,404,574,575,576,36,577,578,69,579,339,580,194,86,165,405,196,234,375
104,152,357,69,536,44,240,516,105,120,79
105,116,76,4,3,48,177,117,8,115,71,74,47
106,581,236,69,496,210,38,265,582,104,15,83,90,12,76
107,581,583,34,340,584,181,65,585,69,225,54,586,277,275,554,587,118,588,24,338
108,225,471,280,13,40,62,470,86
109,131,115,177,74,327,89,76,77,42,4,48,3,106,17,116,105,121,117,71
110,236,86,389,114,71,69,176
111
112,56,40,104,72,73,62
113,61,56,58,277,69,4,504,3,589,340,86,130,89,108,74,512,15,17
114,100,115,105,42
115,62,161,132,42
116,236,590,208,364,85,591,476,543,592,104,86,521,593,594,473,389,126,391,357,595
117,47,69,590,596,597,598,599,600,146,601,158,133,79,357,170,162,516
118,62,69,13,15,86,6,12,79,45,7,74,340
119,56,34,24,340,38,225,512,602,280
121,86,104,79,603,15,121,11,565,133,170,199,83,12,131,74,47,327,105,76,106
122,76,34,38,125,604,474,254,605,118,606,46,85
123,393,391,399,400,55,607,84,608,125,126
124,12,15,6,443,7,89,77,121,39,4,3,48,327,17,105,38
125,204,47,243,125,609,610,337,310,70,611,102,467,132,161,606,612,613,614,31,615
126,616,86,62,512,99,75,73,16,515,131,47,15,327,74,115,102,71,105,89,76
127,180,617,306,461,462,618,125,506,404,197
128,62,15,115,74,327,105,71,76,89,39,4,48,12,73,3,75
129,127,103,70,69,619,104,86,271,126,93,11,620,3,47,621,62,42,536
130,69,12,615,622,15,62,623,624,74,76,11
131,409,505,46,168,184,625,626,627,628,629,630,631,56,61,112,302,332,55,632,90
132,77,75
133,633,634,635,509,636,496,637,638,639,41,640,581,583,227,641,642,643,644,645,646
134,171,272,647,648,3,649,45,105,172,8,269,106
135,650,651,329,30,103,94,7,6,34,93,125,394,505,97,458,118,529,61,40,69
136,62,12,109,77,39
137,652,62,15,83,17,47,39,11,3,4,48,177,12,117
138,62,653,15,79,654,501,44,8,46,606,47,512,73,75,39,12,117,106,76,3
139,75,38,31,238,86,325,366,62,112,73,327,12,77
140,655,656,470,657,280,602,658,659,660,35,661,13,165,662,538,663,331,664,72,665
141,342,232,103,102,432,339,465,30,506,125,641,40,225,24,498,86,97,7,666,105
142,340,47,93,3,389,72,106,90,16,71,76,74,177,17,11
143,667,232,668,93,669,476,670,591,671,516,99,672,673,674,675,676,594,677,678,172
144,679,273,62,46,130,179,8,131,47,4,48,114,113,172,512,199,99,45,112,73
145,680,681,682,617,683,382,684,685,686,687,688,211,529,564,689,690,490,691,692,693
146,509,340,103,502,93,444,677,694,104,315,176,69,119,305,515,17,38,117
147,362,114,8,679,360,85,99,272,106,386,16,172,523,695,675,130,69,83,170,696
148,34,12,3,11,244
149,105,197,93,34,270,88,62,125,126,112,89,76,48,79,75,73,44,71,47,327
150,697,698,196,103,24,699,700,701,167,366,47,92,506,702,703,25,3,102
